0 0 0 0 0 0 0 0 0 0 0 0 0 0 0 0 
0 0 0 0 0 0 0 0 0 0 0 0 0 0 0 0 
28 28 85 86 87 88 89 90 91 92 93 94 95 96 28 28 
28 28 97 98 99 100 101 102 103 104 105 106 107 108 28 28 
28 28 109 110 111 112 113 114 115 116 117 118 119 4 28 28 
28 28 121 122 123 124 125 126 127 128 129 130 131 132 28 28 
0 28 133 134 135 136 137 138 139 140 141 142 143 144 7 8 
28 28 28 28 28 28 28 28 28 28 28 28 17 18 19 20 
25 26 27 28 28 28 28 28 28 28 28 28 29 30 31 32 
37 38 39 40 28 28 28 28 28 28 28 28 41 42 43 44 
49 50 51 52 6 6 6 6 6 6 6 6 53 54 55 56 
61 62 63 64 6 6 6 6 6 6 6 6 65 66 67 68 
73 74 75 76 28 57 58 59 45 46 47 48 77 78 79 80 
0 0 0 0 0 0 0 0 0 0 0 0 0 0 0 0 
0 0 0 0 0 0 0 0 0 0 0 0 0 0 0 0