0 0 0 0 0 0 0 0 0 0 0 0 0 0 0 0 
1 1 1 1 1 1 1 1 1 1 1 1 1 1 1 1 
0 0 0 0 0 0 0 0 0 0 0 0 0 2 3 0 
0 2 3 0 0 0 0 0 0 0 0 0 0 14 15 0 
0 14 15 0 0 0 0 0 0 0 0 0 0 0 0 0 
0 0 0 0 0 0 0 0 0 0 0 0 0 0 0 0 
13 0 0 0 0 0 0 0 0 0 0 0 0 0 0 0 
0 0 0 0 0 0 0 0 0 0 0 0 0 0 0 0 
0 0 0 0 0 0 0 0 0 0 0 0 0 0 0 0 
0 0 0 0 0 0 0 0 0 0 0 0 0 0 0 0 
0 0 0 0 145 146 147 148 149 150 151 152 0 0 0 0 
0 0 0 0 157 158 159 160 161 162 163 164 0 0 0 0 
9 10 9 10 9 10 9 10 9 10 9 10 9 10 9 10 
21 22 21 22 21 22 21 22 21 22 21 22 21 22 21 22 
33 34 33 34 33 34 33 34 33 34 33 34 33 34 33 34