31 31 31 31 31 31 31 31 31 31 31 31 31 31 31 31
25 32 32 32 32 32 32 32 32 32 32 32 32 32 32 26
23 1 1 1 57 21 6 21 58 21 59 21 6 1 1 24
23 1 1 1 22 1 1 1 22 1 1 1 22 1 1 24
23 21 55 21 8 1 1 1 7 21 60 21 19 1 1 24
23 1 1 1 20 1 1 1 22 1 1 1 1 1 1 24
23 1 1 1 7 21 4 21 44 1 1 13 11 12 1 24
23 1 1 1 22 1 1 1 1 13 11 15 2 10 1 24
23 1 1 17 7 17 19 21 6 14 6 21 3 10 1 24
23 1 17 17 22 17 17 1 22 10 1 1 1 10 1 24
23 1 17 17 61 21 6 21 62 16 11 11 11 15 1 24
23 1 1 1 1 1 1 1 1 1 1 1 1 1 1 24
34 33 33 33 33 33 33 33 33 33 33 33 33 33 33 35 
31 31 31 31 31 31 31 31 31 31 31 31 31 31 31 31 
31 31 31 31 31 31 31 31 31 31 31 31 31 31 31 31
